dochodzic w  - reach in
manewrowac - maneover
stanik - bra
rekaw - sleeve
za czyms - beyond
zlosliwy - mean
ani jednego - not a one
niezreczny - awkward
dzialac razem - gang up
gumka do wlosow - scrunchie
kabriolet - convertible
obrzydliwy - horrible
chetny - eager
cudaczny - freakish
zbieg okolicznosci - coincidence
pranie - laundry
mechaty - fluffy
alfabet - belch
przysluga - favor
obozowicz - camper
wtulanie sie - snuggle
niezwykle - supremely
okropnie - awful
dowod - proof
tak jakby - kind of
mydliny - suds
kretyn - spaz
skubac - nibble
wiewiorka - squirrel
lasica - weasel
niesamowity - terrific
odslaniac - expose
zasmucony - upset
slabeusz - underdog
napompowac - inflate
nieodpowiedni - inappriopriate
niesforny - rambunctious
talia - waist
nieprawdopodobny - incredible
powinien - ought (You ought to stop smoking)
