metro - subway
od kiedy? - since when?
narzekac - complain
zamortyzowac uderzenie - cushion the blow
scigac - chase
cela wiezienna - cell
nadgarstek - wrist
wupuszczac dym - puff
kciuk - thumb
palec wskazujacy - index finger
bezsensowny - ridiculous
doskonale - excellent
mamotanie - mubling
sluga - minion
razaco - gross
nagrowa - reward
zrozumiec czyjes zachowanie - figure out
seplenienie - lisping
tlum, stado - herd
czesc - share of
rozgladac - look out
szanse - odds
krytykowanie - bashing
nieuczciwy - crooced
miara - yardstick
przemyslany - measured
wrodzony - innate
wielbic - adore
slone krakersy - saltines
do zobaczenia - see ya
konkurs - contest
skaza, wada - flaw
denerwujacy - annoying
urocze - endearing
w rzeczywisto≈õci - indeed
wilk - coyote
rzucac - dump
sedno sprawy - the bottom line
plaster antynikotynowy - patch
