ledwie - barely
wygrana - winning
oblakane, szalone (o planie) - insane
belkot - sputter
czubek - creep
osmielac sie - dare
zostawic, opuscic (kogos) - bail on (someone)
zalosny - pathetic
bedacy w potrzebie - needy
czuly - vulnerable
kalifornijska winorosl wlasciwa - zinfandel
oczyszczajacy - cleansing
dobrowolnie - voluntarily
spiewać - chant
od tamtej pory - ever since
apartamenty - quarters
zaczynac na nowo - pick up
okrucienstwo - cruelty
pokryc - slather
lick off - wylizać
mus - mousse
na wynos - to go
najdrozsze, zbyt drogie - overpriced
ponowne polaczenie, spotkanie - reunion
zle samopoczucie z powodu roznicy miedzy strefami czasowymi - jet lag
etykieta - label
szalwia - sage
galaz - branch
cnotliwy - righteous
nasienie - semen
bokserki - boxer shorts
bez domieszek - pure
swat, swatka - matchmaker
tak szybko jak - as soon as
glowny - major
przesunac sie (miejsca siedzace) - scooch
w dziwny sposob - funnily
kartka z zyczeniami - greeting card
w pol zweglony - half charred
wlochaty - hairier
naczelny - chief
najbardziej pracowita noc - busiest night
nabity (o broni) - loaded
odszukac - seek (someone) out
rog mglowy (syrena okretu) - foghorn
schrzanic - screw up
zwariowany, odjechany - wacky
szansa - shot
na bok - aside
zatyczka - pin
zaprzeczyc - deny
