zoltobrazowy - buffy
zaciemnienie - blackout
zlodziej - looter
uprawniony - eligible
ukochana - jill
otwarte pomieszczenie - atrium
przedsionek - vestibule
powiedz cos - make contact
podac do telefonu - put (somebody) on the phone
zaklinowany - trapped
stol bilardowy - pool table
park rozrywki - theme park
przereklamowany - overrated
w koncu - eventually
burmistrz - mayor
baza - groundwork
bez cukru - sugarless
poszarpany - mangled
padlina - carcass
paw - peacock
uderzyc - whip
zmeczony - whipped
deptac - trample
doskonalosc - perfection
brzydzic sie - loathe
byc winnym - owe
masz racje! - you betcha!
na sto procent! - you bet!
chlopiecy urok - boyish charm
psotny - impish
urwis - imp
dosiegnac - reach over
powierzchowny - superficial
upiornie - spooky
jeczec - groan
niepokoj - anxiety
