wszechmocny - omniponent
niepewny - insecure
gluchy - deaf
piana - foam
wyplata - paycheck
wycierac - wipe
gotowac - steam
niesamowity - terrific
fartuch - apron
oltarz - altar
drzemka - slumber
przygotowac - prep
mroz - frost
osoba niezdecydowana - flupie
bezzebny - toothless
trudne po≈Çozenie, dylemat - predicament
uszczerbek - dent
zakuta pala - bonehead
interesujaco - curiously
zachwycajacy - stunning
recznik - towel
zwariowany - nuts
szpiegostwo - spying
doradca - advisor
dupa - butt
wyciagac pieniadze z banku - draw out
elegancki - preppy (prepi)
jesli nie - unless
ges, uszczypnac w tylek - goose (gus lub gis)
najmniej - least
przegrani - weapers
rozrabianie - roughhousing
