résumé - podsumowanie
lousy - kiepski
proofread - sprawdzac
scone #buleczka
inquiry - prosba, list z zapytaniem
pounding - uszkodzenia
yarn - opowiadac bajki
be over somebody - #przestac byc kims zauroczonym
weep - plakac
lame - kulawy
excuse - wymowka
spade - pik w kartach, lopata
club - trefl
straight - strit w pokerze
assorted - mieszany
crudités - surowe warzywa w kawalkach
stake - stawka
settle - uregulowac, rozstrzygnac
rematch - rewanz
buck - dolec, dolar
get your ya-yas out - cieszyc sie w niepohamowany sposob
dealt - rozdane (o kartach)
competitive - zmuszajacy do rywalizacji
differ - roznic sie
pictionary - gra slowna, zgadywanka
gesturing - gestykulowanie
slip out - wyslizgnac sie
pure - czyste
crap - pierdola
cave - ustapic pod presja
Trident - nazwa firmowa gumy do zucia sprzedawanej w USA
cursed - przekleta
exert - okazywac
dime - dziesieciocentowka, bardzo atrakcyjna osoba
as a formality - dla porzadku
chit-chat - gadka szmatka
hold something over - odwklekac cos
fly - rozporek
hop out - wyskakiwac
flush - kolor (w pokerze)
bucko - chlopak
inner - wewnetrzny
fold - ulec presji
hooker - prostytutka
sore - rana
temple - skron
ante - stawka, wejscie (w grze karcianej)
full house - ful w grze pokera
unbearable - nieznosny

