slodki (o osobie) - precious
kaplica na statku - bethel
pewne, niektorzy - certain
zalosny - pathetic
balwan - snowman
sklep - store
radosny - jolly
cos obrazliwego, policzek (idiom) - slap in the face
wspinaczka - scramble
upuscic - drop
uklad - pact
zadanie, postulat - demand
oczarowac - betwitch
metodyczny - methodical
wegiel - coal
sloik - jar
lsniacy - luminous
delikatny - delicate
wdziek - grace
odrobina, kapka - smidge
puscic (o nerwach) - snapped
drwic - mock
szpatulka kuchenna - spatulas
wazny - valid
facet, gosc - fella
ludziska - folks
podskakiwac - hop
wlec (ciagnac cos z trudem) - drag
dobra zabawa, ubaw - blast
a niech to! - blast it!
zonglowanie - juggling
zamkniete w kulke - balled-up
karczoch (rodzaj rosliny) - artichoke
dieta - diet
oddawac mocz - urinate
mielenie - milling
dogonic (kogos), osiagnac (czyjs) poziom - catch up with (somebody)
taxi - cab
portfel - pocketbook
zablokowac (przeciwnika w grze) - tackle
krawznik - curb
sos (do maczania kasek) - dip
odprawa - check in
odejsc - get away
ponownie polaczyc, scalac - reunite
blask - glitter
rozedrzec (cos) na strzepy - tearing (something) apart
prawie - almost
radosc - joy
od nas - upon us
pchla - flea
porysowany, popekany - cracked
