okazywac uczucia - act out
fartuch - apron
rzekomo - supposedly
lubic sie, dobrze dogadywac - get along
przewaznie - mostly
pomimo ze - even though
lista - roster
posylac (kogos) - send (something) in
opatrywanie pozniejsza data - postdating
szalony, nienormalny - whack
suma pieniedzy, proba - whack
zepsuty - out of whack
atrament - ink
zanurzac (np. pioro w atramencie) - dip
odlegly - remote
rozswietlac cos - light (something) up
radosny - merry
zdjac (np. lampki z choinki) - take (something) down
roztapiac - melt
taka kanapka z tunczykiem - tuna melt
kontynuowac (cos) - stick at (something)
wizytowka - business card
podrzucac - flip
oczyszczajacy - cleansing
coroczny - annual
dosyc brzydki - pretty ugly
zwalniac pracownikow - lay off
marynarz - salt
miecznik - swordfish
wloskie ciasteczka, cantuccini - cantuccini, biscotti
krotka pilka, szybka robota, szybkie pytanie, szybki numerek (seks) - quickie
sufit - ceiling
szaleństwo - frenzy
wspomnienie - recollection
groźba - threat
nozdrze - nostril
mięso duszone z warzywami - pot roast
to wlasnie to Ci przychodzi do glowy? (w tej chwili) - this is just occurring to you?
mata kąpielowa - bathmat
wychowywac (np. dziecko) - raise
krorekolwiek z (czegos) - any of
zazdrosny o - jealous of
nozyczki - scissors
zszywacz - stapler
termos - thermos
