wykrzyknik - excalamation point
bez obaw - no fear
zauwazyc, zdawac sobie sprawe - notice
smierc - doom
zauwazyc - point out
odnawiac asortyment - restock
alkohol, gorzala - booze (buz)
dostrzec - spot
nieuchronny - impedning
penis - dinkle, schwang
dzwieczenie - tinkle
wieszac - hang
zgwalcony (o umysle) - violated
sciagac cos z siebie - peel (something) off
pierwszy krok - opening line
swiadomy - aware of
biletowy (w teatrze) - usher
namietnosc - passion
ledwo - barely
owdowialy - widowed
monogamia - monogamy
trudny - tricky
pojecie - concept
koncowka (np. do odkurzacza) - attachment
pufa - ottoman
rozlozyc (np. rzeczy na stole) - fan out
wykreslic - scratch out
mierzyc - measuring
nieosiagalny - unattainable (anateinabl)
niepokojacy - disturbing (disterbing)
przepuscic (np. okazje) - blow
gowniane - crappy
okazja - shot
rozrzucac - strew (stru)
mimochodem - casually
nieostrozny - reckless
przypadek, los szczescia - haphazard
maniera - manner
udowadniac - prove
nie uczciwe - unfair
zapuszczony - raggedy (ragedi)
czubek - kook
dziewczyna - gal
wariat - madcap
sklep spozywczy - grocery
podkladka pod kubek - coaster
kropla - bead (bid)
posuwac sie wolno - inching
zmagac sie, borykac sie - strugle
krem nawilzajacy - moisturizer (moistszeraizer)
gniew - resentment (rizentment)
szorowac - scrub
szlafrok - robe
zasmucony - upset
zalowac - regret
spelniona/y - fulfilled
zobowiazany - obligated
zbierac lzy w oczach ze szczescia - well up
