plunge - wpasc
spiaczka - coma
zakladac - bet
swiadomy - conscious
pachwina - grain
promienny - beaming
duma - pride
byc w sytuacje intymnej - be intimate
laknienie, pragnienie - craving
wybuchac - burst
czlowiek czynu - doer (pronounciation - duea)
naczynie - vessel
ci ktorza wiedza najmniej sa najczesciej najglosniejsi - empty vessels make most noise
ci ktorza wiedza najmniej sa najczesciej najglosniejsi - great talkers are little doers
zmniejszenie deficytu - deficit-reduction
glodny jak wilk - famished
poczucie czasu - track of time
poczucie czasu - time sense
oceniac, szacowac - appraise
tuzin - dozen
eufenizm - euphenism
slimaczany - slugger
sutek - nipple
zaspac - oversleep
chwyt - hold
szpilka do wlosow, chwyt - grip
ochraniacz na krocze - jock strap
trzaskac - slam
wyzwolony - liberated
dzins (material) - denim
napuchniety, nabrzmialy - engorged
powalajaca - knockout
skomplikowany - complex
zestaw - set of
robienie proby teatralnej - rehearsing
zamroczony, otumaniony - woozy
widywac - see around
do zobaczenia! - see you around
zakazany - forbidden
