dobre pytanie (szybka odpowiedz) - indeed
trzec - scrape
uderzyc z nienacka - plunk down
macica - uterus
lozysko - placenta
osoba lub firma zajmujaca sie organizacja przyjec - caterer
pstryczek - poke
przelotny zwiazek, przygoda milosna, ciskac ze zloscia - fling
jak to mozliwe - how come
harmonia, jednosc - unison
wielkie rzeczy..! - big deal..!
dac cynk (info) - tip (somebody) the wink
przyprawiajacy o mdlosci - nauseuos
ze soba - along
punkcja owodni - amniocentesis
z pewnoscia - certainly
grupa ludzi, ludziska - folks
domofon - intercom
wrazenie - impression
poswiecenie - commitment
grill w stylu japonskim - hibachi
zwiewac - run off
zielny - herbal
przesuwac (plany) - push back
siatsu (masaz japonski) - shiatsu
nie w sosie - out of sorts
klasyfikowac - classify
segregowac - file
podrywac (kobiete) - move on
zobowiazanie - obligation
taras - patio
owsiankowo rodzynkowe - oatmeal-raisin
rodzynka - raisin
owsianka - outmeal (usa), porridge (british)
udowadniac - prove
zlew - sink
uwaga na glowy! - heads up!
glowa do gory! - get hopes up!, chin up!
zazenowana - embarassed
wyzwalac - unleash
wkroczyc do akcji - swoop in
zrozpaczony - distraught
zapoczatkowac (cos) - usher in
gestykulowanie - gesturing
machanie rekoma - arm-waving
olbrzymi - enormous
przytloczony - overwhelmed
zaslugiwac - deserve
odmawiac - swear off
calkowicie - altogether
poddawanie kontroli - screening
wylaczyc - shut down
mieczak - wussy
