wino jablkowe - cider
gumka do scierania - eraser
twarzowy (o ubraniu) - flattering
zawiadomienie - memo
zachowywac sie - act
wprowadzanie (danych) - inputting
kierownik - supervisor
chwilowy - temp
przyznawac sie - admit
okreslenie - term
tygodniowo - weekly
przyblizony - estimated
uzytkowanie - usage
stanowiacy mieszanke wielu roznych rzeczy - eclectic
wizyta (u lekarza) - appointment
doradca, adwokat - counselor
mniejszy - lesser
niegdys - formerly
pyszne - yummy
uncja - ounce
wkurzajaca, wirus - bug
opiekun prawny - curator
przenosnie (mowienie) - metaphorically
laska - chick
futrzany - furry
przypieczetowac umowe - seal the deal
lagodzaca barwa glosu - soothing tone
pazur - claw
kremowy - creamier
zmeczony - whipped
zdolnosc - aptitude
wyobrazac - picture
przystawka powitalna - amuse-bouche
zabawne - amusing
utrzymywanie - maintaining
przechwalac sie - brag
srom - vulva
strata - loss
przytulanie sie - cuddling
piescic - caress
drganie - trembling
zakorzeniac sie - root
brak skrupulow - hardball
odmowa - rejection
boks biurowy - cubicle
odpadla, zmyla sie - bailed
joint - doobie
buchac plomieniem - blaze up
krewetka - shrimp
pierozki, ravioli - ravioli
kolendra - cilantro
mielony - minced
imbir - ginger
tonacy (o osobie) - drowning
gosc - fella
w kierunku - onto
paskudztwo - filth
zlozony - elaborate
motyw - motive
temat - theme
