ledwie - barely
wygrana - winning
obłąkane, szalone (o planie) - insane
bełkot - sputter
czubek - creep
ośmielać się - dare
zostawić, opuścić (kogoś) - bail on (someone)
żałosny - pathetic
będący w potrzebie - needy
czuły - vulnerable
kalifornijska winorośl własciwa - zinfandel
oczyszczający - cleansing
dobrowolnie - voluntarily
śpiewać - chant
od tamtej pory - ever since
apartamenty - quarters
zaczynać na nowo, podnosić - pick up
okrucieństwo - cruelty
pokryć - slather
lick off - wylizać
mus - mousse
na wynos - to go
najdroższe, zbyt drogie - overpriced
ponowne połączenie, spotkanie - reunion
złe samopoczucie z powodu różnicy między strefami czasowymi - jet lag
etykieta - label
szałwia - sage
gałąź - branch
cnotliwy - righteous
nasienie - semen
bokserki - boxer shorts
bez domieszek - pure
swat, swatka - matchmaker
tak szybko jak - as soon as
głowny - major
przesunąć się (miejsca siedzące) - scooch
w dziwny sposób - funnily
kartka z życzeniami - greeting card
w pół zwęglony - half charred
włochaty - hairier
naczelny - chief
najbardziej pracowita noc - busiest night
nabity (o broni) - loaded
odszukać - seek (someone) out
róg mgłowy (syrena okretu) - foghorn
schrzanić - screw up
zwatiowany, odjechany - wacky
szansa - shot
na bok - aside
zatyczka - pin
zaprzeczyć - deny
