wybrzuszenie - hump
jelito - intestine
chwytac - grab
bezkofeinowy - decaf
druchna - bridesmaid
spoko - gravy
olsniewajacy - gorgeous
wychodzic z siebie - freaking out
oddalac sie od siebie (2 ludzi) - drift apart
organy piszczalkowe - pipe organ
torebka damska - purse
wprowadzac sie (do mieszkania) - establish
kropla deszczu - raindrop
sanie - sleigh
rekawice bokserskie - mittens
niezaleznosc - independence
rzesa - eyelash
spedzac czas - hang out
przymocowac - attach
grupa - bunch
nawias - bracket
wkrecony - screwed (you got screwed)
przypadkowo - accidentally
wzdychac - sighs
napalony - horny
wystepowac - perform
pluc - spit on
wieszak - hanger
wyrafinowany - sophisticated
powazny - severe
optymistyczny - upbeat
przednia szyba w samochodzie - winshield
