metro - subway
od kiedy? - since when?
narzekać - complain
zamortyzować uderzenie - cushion the blow
ścigać - chase
cela więzienna - cell
nadgarstek - wrist
wupuszczać dym - puff
kciuk - thumb
palec wskazujący - index finger
bezsensowny - ridiculous
doskonale - excellent
mamotanie - mubling
sługa - minion
rażąco - gross
nagrowa - reward
zrozumieć czyjeś zachowanie - figure out
seplenienie - lisping
tłum, stado - herd
część - share of
rozglądać - look out
szanse - odds
krytykowanie - bashing
crooked - nieuczciwy
yardstick - miara
przemyślany - measured
wrodzony - innate
wielbić - adore
słone krakersy - saltines
do zobaczenia - see ya
konkurs - contest
skaza, wada - flaw
denerwujacy - annoying
urocze - endearing
w rzeczywistości - indeed
wilk - coyote
rzucać - dump
sedno sprawy - the bottom line
plaster antynikotynowy - patch
