wybrzuszenie - hump
jelito - intestine
chwytać - grab
bezkofeinowy - decaf
druchna - bridesmaid
spoko - gravy
olśniewający - gorgeous
wychodzić z siebie - freaking out
oddalać się od siebie (2 ludzi) - drift apart
organy piszczałkowe - pipe organ
torebka damska - purse
wprowadzać się (do mieszkania) - establish
kropla deszczu - raindrop
sanie - sleigh
rękawice bokserskie - mittens
niezależnośc - independence
rzęsa - eyelash
spędzać czas - hang out
przymocować - attach
grupa - bunch
nawias - bracket
wkręcony - screwed (you got screwed)
przypadkowo - accidentally
wzdychać - sighs
napalony - horny
występować - perform
pluć - spit on
wieszak - hanger
wyrafinowany - sophisticated
poważny - severe
optymistyczny - upbeat
przednia szyba w samochodzie - winshield
