wypelniac - fill out
fiu fiu - whew
ubezpieczenie - insurance
oszustwo ubezpieczeniowe - insurance fraud
rowniez - as well
wedrowac - hike
rzucac, ciskac - heave
z gory w dol - downhill
worek - sack
napad zlosci - hissy fit
szafran - saffron
zwichniecie - sprain
szalone, niepoczytalne - insane
olac kogos - blow (somebody) off
jak dotad - so far
dac dupy - crap out
papka - mush
czy masz cos przeciwko - would you mind?
sliwka suszona - prune
panikarski - panicky
nagle - all of the sudden
piesc (od reki) - fist
scisniety - squeezed
piwnica - cellar
opierac sie (pokusie) - resist
od reki - stat
cykor - wuss
poganski - pagan
stos - pile
nerwowy - uptight
hummus (pasta z ciecierzycy) - hummus
od lepszej dzielnicy - uptown
glownie, przewaznie - mostly
ciecierzyca - chickpea
rozpieszczony - spoiled
uczen pierwszej klasy liceum - freshman
dopuszczenie - admission
stukniety, szalony - nutsy
dotkniete - affected
malpa - simian
klaczek - fur ball
kafelek (np od scrabble) - tile
albo jeden - either
