nieostrozny - reckless
zapomniec o rozsadku - throw caution to the winds
palant - geek
przenosic z trudnoscia - hump
budzic grozę - intimidate
zaopatrzenie - supply
konno - horseback
rodowity - ethnic
skrzypek, kanciarz, oszust - fiddler
podsluchiwac - tap
fuj, ohyda - yuck
wolny czas - spare time
oszczedz mi, daruj sobie - spare me
dawac - spare
czesci zamienne - spares
spięty - tense
weterynarz - vet
stożek plastiku (zeby pies się nie gryzł) - plastic cone
dojrzałość - maturity
agresywny - vicious
pozastanowy - out-of-state
rodzaj - brand
strażnik - vigilante
szalony - insane
wprawiający w osłupienie - astounding
siła - brunt
zarzynać, robić masakre - slaughter
potulny - docile
amabasada - embassy
Scranton - miasto w Pensylwani
gafa, potkniecie - fluff
wydać (kogoś np policji) - turn somebody in
niekoniecznie - not necessarily
zapędzony w kozi róg - cornered
spółgłoska - consonant
luźno - loosely
tymianek - thyme
Justin Thyme - Just in time (funny combination)
Holden McGrain - holden my grain (trzymaj mnie za krocze) (funny combination)
