stosunkowo - relatively
splot (np. od tkaniny) - weave
psychiatra (humorystyczne okreslenie) - shrink
couch - kanapa
plyta winilowa - vinyl
smiech - laughter
pelen zycia - sparky
bliskosc - intimacy
okres dojrzewania plciowego - puberty
srodmiejski - midtown
holowanie - hauling
naprzod - forth
poruszac sie naprzod - move forth
wizyta u lekarza - appointment
wlasciciel zakladu pogrzebowego - mortician
penis - pee-pee
cycek - tit
poczucie wlasnej wartosci - self-esteem
zaciemniac - overshadow
rodzenstwo - rodzenstwo
mozliwe do pomyslenia, wyobrazalny - conceivable
popelniac sabotaz - sabotage
chwiac sie, kiwac sie (np. na krzesle) - wobble
latwa kasa, szmal (slang) - gravy
trudny, wymagajacy - tough (pronounciation - taf)
spokojnie (do kogos nie o kims)- easy
zator - embolism
surowy - strict
kopiacy - kickie
ustapic pod presja, poddac sie - cave
odwaga - guts
kochanka - mistress
wnikliwy - perceptive
mocne uderzenie - big ring
smieci - garbage
niegrzeczny, nie okazujacy szacunku - disrespectful (I dont mean to be .. )
zawstydzony - ashamed
baczny, uwazny, troszczacy sie - attentive
reagujacy emocjonalnie - intense
opozniony w rozwoju, wyczyn kaskaderski - stunted
powstrzymywanie (kogos) - restraining
sadowy zakaz zblizania sie - restraining order
