miserable - przygnebiony
fraud - oszustwo
patronize - wspierac
forbid - zabraniac
loophole - luka
mortal - smiertelny
widdle - siusiac
notability - znakomitosc
inclined - usposobiony
whoosh - podmuch
kindred - bratni
enchant - zaczarowac
utterly - calkowicie
dapper - zywy
sniff - wąchać
enchantment - czary
jackal - szakal
shyster - krętacz
rivarly - rywalizacja
crested - grzywiasty
lobster - homar
quicksand - ruchome piaski
fair enough - zgoda
accuse - oskarzac
water under the bridge - bylo minelo
comprehend - pojmowac
rebuke - zbesztac
invoked - odwolywac
transgression - naruszenie
vengeance - zemsta
