hon - kochanie
leisure - czas wolny
puke - rzygać
flee - uciekać
unimaginable - niewyobrażalny
rest assured that - proszę się nie martwić o
rewind - przewijać do tyłu
ship - wysyłać
attic - strych
splinter - drzazga
shack - buda, szopa
behold - ujrzeć
merchandise - towar (na wystawie)
fateful - nieuchronny
rigged - ustawiony
phase - etap, faza
overdo - przesadzac
mattress - materac
mock - drwić
mosquito - komar
mosquito bite - ugryzienie przez komara
beware! - strzeż sie!
wondrous - cudowny
suspicion - podejrzenie
spill the beans - wyjawić sekret
irresistible - nieodparty
slick - przystojniaczek
consult - miec na uwadze
mistaken - błędny
daisy - stokrotka
scallywag - łobuz
dilemma - dylemat
overhear - przypadkiem podsluchac
aloud - na głos
mailman - listonosz
werewolf - wilkołak
major league - pierwszoligowy
cuckoo clock - zegar z kukułką
wisdom - rozsądek
bless and curse - błogosławiona i przeklęta
portable toiled - przenosna toaleta
clogged - zablokowany, zapchane
elsewhere - gdzie indziej
smooch - namiętny pocałunek
limp - kuleć
blink - mrugać
adorable - cudowny
dreamy - marzycielski
conspiracy - spisek
kidnap - uprowadzić
butt-face - dupek
be capable of - byc zdolnym do
trifle - lekceważyć
assemble - gromadzic się
dang - cholera!
distracting - rozpraszający
bride - panna młoda
pat - poklepac
overstock - miec nadmierne zapasy
