ultimate - ostateczny
mountie - członek Królewskiej Kanadyjskiej Policji Konnej
knucklehead - półgłowek
mazel tov - gratulacje
bonding - tworzenie więzi
county jail - więzienie okręgowe
blindfold - opaska na oczy
heighten - podnosic
cataract - bielmo (choroba siatkówki)
woodpecker - dzięcioł
lodge - domek
suck-up - lizus
pine - sosna, sosnowy
goofy - głupkowaty
gobble - pożerać
wonk - pracuś, kujon
scram - znikać
doodle - bazgroły
jig - rytmicznie poruszać sie, giga (rodzaj tańca)
grave - poważny, nie na żarty
smithereens - kawałeczki, drobne kawałki
scuttlebutt - plotka
donkey - osiol
spittle - ślina
untie - rozwiązać (węzeł)
snag = złapać, capnąć (np. zdjęcie (USA))
mighty - ogromny
squeak - piszczeć (o zwierzęciu)
onboard - na pokładzie
knot - węzeł
ingrate - niewdzięcznik
lure - przynęta
hoist - podnosić
anchor - kotwica
sunscreen - krem z filtrem UV
disposable - jednorazowy
lookout - czaty
rapscallion - łajdak
majestic - królewski
elusive - nieuchwytny
ditch - olewać, wagarować
pursue - dążyć do
cavorting - hasanie
chainsaw - piła łańcuchowa
after all - mimo wszystko
scrap - świstek
barrel - beczka
beaver - bóbr
cracked - popękana
mollycoddling - mamisynek
seek revenge - szukać zemsty
aquatic - wodny
contrived - naciągana
homicidal - morderczy
