niedogodnośc - inconveniencing
kretyn - dork
podkradać się - sneak up
przypominający owieczki - lamby
ogon - tail
paść się - graze
pastwisko - grazing
reagujący emocjonalnie - intense
odwaga, determinacja - moxie
rok przestępny - leap year
śmieszny - risible
sternik (z żeglarstwa) - coxswain
skazany, przeznaczony do rozbiórki - condemned
nieźle! - neato!
wtargnąć - trespass
sprawca - violator
ścigany - prosecuted
oparcie pod stopą - foothold
zablokowany - stuck
spadaj!, zjeżdżaj! - get lost!
najwyższa stawka - jackpot
tworzenie więzi - bonding
łapa - paw
pięści (po amerykańsku) - dukes
użytkownik wspólnych gruntów - commoner
księżna (tytuł) - duchess
uścisk - ahold
dalszy - onward
kusić, nakłaniać - tempt
nawiedzony - haunted
nacięcie - notch
zabójca frajdy - captain buzzkill
oszalały, kopnięty - bonkers
plaga - scourge
nowomodny - newfangled
żądać zwrotu, odbierać (bagaż) - reclaim
męskość - manliness
